NO ./path_to_the_north_texture
SO ./path_to_the_south_texture
WE ./path_to_the_west_texture
EA ./path_to_the_east_texture

F 220,100,0
C 225,30,0

11111111111			11111111111111
10000000001			10000000000001
10110000011111111111110000000000001
1001000000000000000000001111111111
111111111011000001110000000000001
10000000001100000    1110111111111111
11110111111111011    100000010001
111101111111110	1    1101010010001
11000000     1101    01011100000010001
10000000000000001100000010001
10000000000000001101010010001
11000001110101011111011110N0111
11110111 1110101 101111010001