
NO ./path_to_the_north_texture
SO ./path_to_the_south_texture
WE ./path_to_the_west_texture     
EA ./path_to_the_east_texture

F 100,100,100
C 50,30,50

111111111111111111111111
100000000000000000000001
100000000000000000000001
100000000000000000000001
100000111110000101010001
100000100010000000000001
100000100010000000000001
100000100010000100010001
100000100010000000000001
100000110110000101010001111
10000   0000000000000000001
100000000000000000000001111
100000000000  000000000001
1000000000000000000000011
10000000000N000000000001
100000000000000000000001
100000000000000000000001
111111111000000000000001
110100001000000000000001
110000101000000000000001
110100001000000000000001
110111111000000000000001
110000000000000000000001
111111111111111111111111