NO ./path_to_the_north_texture
SO ./path_to_the_south_texture
WE ./path_to_the_west_texture
EA ./path_to_the_east_texture
EA

F 220,100,0
C 225,30,0

11111111     11111111111111111                   
1000000011   11000000000001
10110000011  1111111110001111111
1  001000001100000000000001111111111111
111111111011     000001110000000000001              
1000000000110000011101111111111111111
11110111111111      11100000010001
  111101111111110111010100100011111
11000000111110111000N0  01000111111
1000000001   1000001100 000010001
1000   0011  1000000110101001000111
1100000111   11101111111111010111
11111111      11111111  111111111111