WE ./wallwest.xpm 
NO ./wallnorth.xpm
EA ./walleast.xpm
F 190,150,190
SO ./wallsouth.xpm

C 20,60,50

111111111111111111111111
100030000000000000000001
1000000000N0000000000001
100000000000000000000001
100000111110000101010001
1000001000100000000000011111111111111
100000100010000000000001
100000100010020100010001
100000100010000000000001
100001110110000101010001111
10001   1000000000000000001
100001110000111000000001111
100000000001  100000000001
1000000000001100000000011
100000000000000000000001
1000000000000111110000011111
10000004000001    10000000001
1111111110000111110000011111
110100001000000000000001
11000010100000000000000111111111
110100011111111101000000000000001
1101111111     11110000000000000011
11000000001   100000000000001111111
11111111111   11111111111111