
NO ./path_to_the_north_texture
SO ./path_to_the_south_texture
WE ./path_to_the_west_texture     
EA ./path_to_the_east_texture

F 100,100,100
C 50,30,50

11111111     11111111111111111                   
1000000011   11000000000001
10110000011  1111111110001111111
1001000001111000000000001111111111111
111111111011010001110000000000001              
1000000011111 100011101111111111111111
11110111    1111111100000010001
111101111111110111010100100011111
11000000111110111000N001000111111
1000000001   1000001100000010001
100000111   1000000110101001000111
1100000111   11101111111111010111
11111111      11111111  111111111111