
NO ./textures/wolf/brick.xpm
SO ./textures/wolf/stone.xpm
WE ./textures/wolf/cave.xpm
EA ./textures/wolf/wood.xpm


F 112,112,112
C 56,56,56

111111111111111111
122222200010000001
122222200010110001
122222200010100101
122222200010001101
122222200010000001
122222200010100001
122222200010000001
122222200010000001
1222222000100W0001
122222200010000001
122222200010000101
122222200010000001
122222200010110001
122222200010100101
122222200010001101
122222200010000001
111111111111111111